11111111111
1P0C0000001
10000100001
10001010001
1C010001001
10001010001
100001000E1
10000000001
11111111111