111111111111111111111111111111111111111
100000000000000000000000000000000000001
10P000000000000000000000000000000000001
100000000000000110000000000000000000001
100000000000001001000000000000000000001
100000000000001001000000000000000000001
100000000000001001000000000000000000001
100000000000001001000000000000000000001
100000000000001001000000000000000000001
100000000001101001011101110000000000001
100000000010010001100011001000000000001
100000000010000000000000000100000000001
100000000010000000000000000100000000001
100000000010000000000000000100000000001
100000000010000000000000000100000000001
100000000010000000000000000100000000001
100000000010000000000000000100000000001
100000000010000000000000000100000000001
100000000001000000000000001000000000001
100000000000110000000000110000000000001
100000000000001100000011000000000000001
10C00000000000001111110000000E000000001
100000000000000000000000000000000000001
111111111111111111111111111111111111111