111111111111111111111111111111111
10000100100000110010C000001C001E1
10C00000110100C000100111100010101
10011110C101001010001000111110101
1P010C10010C10111001100C1000101C1
100100000000100C01000010001000001
111111111111111111111111111111111