1111111111111111
1P00000000010001
1000C00000000001
1000001110C00001
100100M010000001
1111000011111111
10000C0000C00E01
100C00CCC0000001
1000000000C00001
1111111111111111