1111111111111111
1P00000000001001
1000C00000000001
1000001110C00001
100100M01000E001
1111000011111111
10000C0000C00E01
1000000000000001
1111111111111111