1111111111111111
1P00000000010001
1000C00000000001
1000001110C00001
1001000010000001
1111000011111111
1000000000C00E01
100C00000M000001
1000000000C00001
1111111111111111