1111111111111111
10000000000100P1
1000C00000000001
1000001110C00001
100100M010000001
1111000011111111
10000C0000C00E01
1000000000000001
1111111111111111