111111
000000
000P00
000000
111111