1111111
1P0C001
10000E1
10C0001
1111111