1111111111111111
10000000000100P1
1000C00000000E01
1000001110C00001
1001000010000001
1111000011111111
10000C0000C00001
1000C00000000001
1111111111111111